#~~~#~~~#~~
~~#~~~#~~##
~~##~#~~~##
#~~$~~#~~~@
#####~~#~#~
######~~~#~
