##~~#@#~~
~#~##~##~
~#~~~~~#~
~~~~###~~
~##~#~~~#
~~~#~~#~#
~#~##~#~~
#$~~~~~#~
~####~#~#
~~~~~~~~~